100
100
PPPPPPPPPPPPPPPPPPPPPPPPPPPPPPPPPPPPPPPPPPPPPPPPPPPPPPPPPPPPPPPPPPPPPPPPPPPPPPPPPPPPPPPPPPPPPPPPPPPP
PPPPPPPPPPPPPPPPPPPPPPPPPPPPPPPPPPPPPPPPPPPPPPPPPPPPPPPPPPPPPPPPPPPPPPPPPPPPPPPPPPPPPPPPPPPPPPPPPPPP
PPPPPPPPPPPPPPPPPPPPPPPPPPPPPPPPPPPPPPPPPPPPPPPPPPPPPPPPPPPPPPPPPPPPPPPPPPPPPPPPPPPPPPPPPPPPPPPPPPPP
PPPTTTTTTTTTTTTTTTTTTTTTTTTTTTTTTTTTTTTTTTTTTTTTTTTTTTTTTTTTTTTTTTTTTTTTTTTTTTPPTTTTTPPTTTKTPPTPPPPP
PPPTTTTTTTTTTTTTTTTTTTTTTTTTPTTTTTTTTTTPPTTTTTTTTPPPPTPPPPTTTTTTTTTTTTTTTTTTTTPPTTTTTPPTTTTPPTPPTPPP
PPPTTTTTTTTTTTTTTTTTTTTTTTPPPPTTTTTTTTTPPTTTTTTTTPPPPPPPTTTTTTTTTTTTTTTTTTTTTPPTTTTTPPTTTTTTPPTTTPPP
PPPTTTTTTTTTTTTTTTTTTTTTPPPPTPPPPTTTPTPPPTPTPBTPPPPTTPTTTTTTTTTTTTTTTTTTTTTTTTAATTTTPPTTTTTTTPPTTPPP
PPPTTTTTTTTTTTTTTTTTTTTBPPTTTTPPPPPPPPPPTPPPPBPPPTPPTTTTTTTTTTTTTTTTTTTTTTTTTTPPTTTTTPPTTTTTTPPTTPPP
PPPTTTTTTTTTTTPTTTTTTPPBTTTTTTTTTPPPTPTPPPTPTTPTTPPTTTTTTTTTTTTTTTTTTTTTTTTTTTTPPTTTPPTTTTTTTPPTTPPP
PPPTTTTTTTTTTPPPTPPPPPPTTTTTTTTTTTTTTTTTPTTTTTTTTTPPTTTTTTTTTTTTTTTTTTTTTTTTTTTPPTTPPTTTTTTTTTPPTPPP
PPPTTTPPTTTTPPTPPPPPPTTTTTTTTTTTTTTTTTTTPPTTTTTTTTTPPTTTTTTTTTTTTTTTTTTTTTTTTTTTPPTPPTTTTTTTTPPPPPPP
PPPPTPPPPTPPPTTTPTTTTTTTTTTTTTTTTTTTTTTTPPTTTTTTTTTPPTTTTTTTTTTTTTTTTTTTTTTTTTTTPPTTPPTTTTTTTTPPTPPP
PPPPPPTTPPPPTTTTTTTTTTTTTTTTTTTTTTTTTTTTPPTTTTTTTTPPTTTTTTTTTTTTTTTTTTTTTTTTTTTTTPPPPPPPPSSPPPPPTPPP
PPPTPTTTTPTTTTTTTTTTTTTTTTTTTTTTTTTTTTTTTPPTTTTTTTTPPTTTTTTTTTTTTTTTTTTTTTTTTTTTPPTPPPMMMMDMMMMPTPPP
PPPTTTTTTTTTTTTTTTTTTTTTTTTTTTTTTTTTTTTTTTPPTTTTTTTPPTTTTTTTTTTTTTTTTTTTTTTTTTTPPTTTTPMSSSSSSSMPTPPP
PPPTTTTTTTTTTTTTTTTTTTTTTTTTTTTTTTTTTTTTTTPPTTTTTTPPTTTTTTTTTTTTTTTKTTTTTTTTTTTTTTTTTPMSSSSSSSMPTPPP
PPPTTTTTTTTTTTTTTTTTTTTTTTTTTTTTTTTTTTTTTTTPPTTTTTPPTTTTTTTTTTTTTTTTTTTTTTTTTTTTTTTTTPMSSSSSSSMPTPPP
PPPTTTTTTTTTTTTTTTTTTTTTTTTTTTTTTTTTTTTTTTTPPTTTTTPPTTTTTTTTTTTTTTTTTTTTTTTTTTTPPTTTTSSSSSSSSSMPTPPP
PPPTTTTTTTTTTTTTTTTTTTTTTTTTTTTTTTTTTTTTTTPPTTTTTTPPTTTTTTTTTTTTTTTTTTTTTTTTTTTTPPTTTPMSSSSSSSDSTPPP
PPPTTTTTTKTTTTTTTTTTTTTTTTTTTTTTTTTTTTTTTTPPTTTTTTTPPTTTTTTTTTTTTTTTTTTTTTTTTTTTTPPTTPMSSSSSSSMSTPPP
PPPTTTTTTTTTTTTTTTTTTTTTTTTTTTTTTTTTTTTTTPPTTTTTTTTPPTTTTTTTTTTTTTTTTTTTTTTTTTTTTPPTTPMSSSSSSSMSTPPP
PPPTTTTTTTTTTTTTTTTTTTTTTTTTTTTTTTTTTTTTKTPPTTTTTTTTPPTTTTTTTTTTTTTTTTTTTTTTTTTTPPTTTPMMMMMMMMMSTPPP
PPPTTTTTTTTTTKTTTTTTTKTTTTTTTTTTTTTTTTTTTTTPPTTTTTTPPTTTTTTTTTTTTTTTTTTTTTTTTTTTTPPTTPPPPPPPSSSSTPPP
PPPKTTTTTTTTTTTTTTTTTTTTTTTTTTTTTTTTTTTTTTPPTTTTTTPPTTTTTTTTTTTTTTTTTTTTTTTTTTTTTPPTPPTTTTTTTTPPTPPP
PPPTTTTTTTTTTTTTTTTTTTTTTTTTTTTTTTTTTTTTTTTPPTTTTTTPPTTTTTTTTTTTTTTTTTTTTTTPPPPPPPPPPPTTTTTTTPPTTPPP
PPPTTTTTTTTTTTTTTTTTTTTTTTTTTTTTTTTTTTTTTTTPPTTTTTTPPTTTTTTTTTTTTTTTTTTTTTTPMMMMMMMMMPTTTTTTTPPTTPPP
PPPTTTTTTTTTTTTTTTTTTTTTTTTTTTTTTTTTTTTTTTTTPPTTTTTPPTTTTTTTTTTTTTTTTTTTTTTPMPSSSSSSDSTTTTTTTTPPTPPP
PPPTTTTTTTTTTTTTTTTTTTTTTTTTTTTTTTTTTTTTTTTTTPPTTTTPPTTTTTTTTTTTTTTTTTTTTTTPMSSSSSSSMPTTTTTTTTPPTPPP
PPPTTTTTTTTTTTTTTTTTTTTTTTKTTTTTTTTTTTTTTTTTTTPPTTTPPTTTTTTTTTTTTTTTTTTTTTTPMSSSSSSSMPTTTTTTTPPTTPPP
PPPTTTTTTTTTTTTTTTTTTTTTTTTTTTTTKTTTTTTTTTTTTPPTTTPPTTTTTTTTTTTTTTTTTTTTTTTSSSSSSSSSMPTTTTTTTTPPTPPP
PPPTTTTKTTTTTTTTTTTTTTTTTTTTTTTTTTTTTTTTTTTTTPPTTTPPTTTTTTTTTTTTTTTTTTTTTTTPMSSSSSSSMPTTTTTPTTPPTPPP
PPPTTTTTTTTTTTTTTTTTTTTTTTTTTTTTTTTTTTTTTTTTTPPTTTTPPTTTTTTTTTTTTTTTTTTTTTTPMSSSSSSSMPTTTPPPPPPTTPPP
PPPTTTTTTTTTTTTTTTTTTTTTTTTTTTTTTTTTTTTTTTTTTTTTTTTTPPTTTTTTTTTTTTTTTTTTTTTPMSSSSSSSMPTTPPPTPPPTTPPP
PPPTTTTTTTTTTTTTTTTTTTTTTTTTTTTTTTTTTTTTTTTTTTPPTTTTTPPTTTTTTTTTTTTTTTTPKPPPMMMMMMMMMPPPPTTTTPPTTPPP
PPPTTTTTTTTTTTTTTTTTTTTTTTTTTTTTTTTTTTTTTTTTTPPTTTTTTPPTTTTTTTTTTTTTTPPPPPPPPPPPPPPPPPPPTTTTPPTTTPPP
PPPPPTTTTPPPTKTTTTTTTKTTTTTTTTTTTTTTTTTTTTTTTPPTTTTTTTPPTTTTTTTTTTTTPPPTPTTTTTTTTTPPPPTTTTTTTPPTTPPP
PPPPPPTTPPPPPPPPBBPTTPPTTTTTTTPTTTTTTTTTTTTTPPTTTTTTTPPTTTTTTTTTTTTPPTTTTTTTTTTTTTPPPPTTTTTTTPPTTPPP
PPPTTPPPPTTTPTTPBBPPPPPPPPTPPPPPPTPTTTTTTTTTPPPTTTTTTTPPTTTTTTTTPTPPTTTTTTTTTTTTTPPTTPPTTTTTTTPPTPPP
PPPTTTPPTTTTTTTTTTTPPTTPPPPPPPTPPPPPPTPTPTTPPPPPTTTTTTTSPTTTPTTPPPPTTTTTTTTTTTTTTTPPPPTTTTTTTPPTTPPP
PPPTTTTTTTTTTTTTTTTTTTTTTTPTTTTTTPTPPPPPPPPPPPTPPPPPPTPSTTPPPPPPTPTTTTTTTTTTTTTTTTTTPPTTTTTTTPPTTPPP
PPPTTTTTTTTTTTTTTTTTTTTTTTTTTTTTTTTTTPTPTPPPPTTTPPPPPPPSTPPPTPPTTTTTTTTTTTTTTTTTTTTPPPPTTTTTPPTTTPPP
PPPTTTTTTTTTTTTTTTTTTTTTTTTTTTTTTTTTTTTTTTPPTTTTTTTTTPASPPAAAAAAAAAATTTTTTTTTTTTTTTTAATTTTTTTPPTTPPP
PPPTTTTTTTTTTTTTTTTTTTTTTTTTTTTTTTTTTTTTTPPTTTTTPPPPPPPSPPPAAAAAAAAATTTTTTTKTAAAAAAAPPAAATTTTTPPTPPP
PPPTTTTTTTTTTTTTTTTTTTTTTTTTTTTTTTTTTTTTTTPPTTTTPMMMMMMDMMPAAAAAAAAATTTTTTTTTAAAAAAAPPAAATTTTPPTTPPP
PPPTTTTTTTTTTTTTTTTTTTTTTTTTTTTTTTTTTTTTTTTPPTTTPMSSSSSSSMPAAAAAAAAAAATTAAAAAAAAAAAPPPPAATTTPPTTTPPP
PPPTTTTTTTTTTTTTTTTTTTTTTTTTTTTTTTTTTTTTTTPPTTTTPMSSSSSSSMPAAAAAAAAAAAATTAAAAAAAAAAPPAPPATTPPTTTTPPP
PPPTTTTTTTTTTTTTTTTTTTTTTTTTTTTTTTTTTTTTTPPKTTTTPMSSSSSSSMSAAAAAAAAAAAATTAAAAAAAAAPPAAAPPTTTPPTTTPPP
PPPTTTTTTTTTTTTTTTTTTTTTTTTTTTTTTTTTTTTTTTPPTTTTPMSSSSSSSMSAAAAAAAAAAAAATTAAAAAAAAAPPAAPPTTTPPTTTPPP
PPPTTTTTTTTTTTTTTTTTTTTTTTTTTTTTTTTTTTTTTTTPPTTTPMSSSSSSSMPAAAAAAAAAAAAATTAAAAAAAAPPAAAPPTTTTPPTTPPP
PPPTTTTTTTTTTTTTTTTTTTTTTTTTTTTTTTTTTTTTTTTPPTTTPMSSSSSSSMPAAAAAAAAAAAATTAAAAAAAAAPPAAAPPTTTTTPPTPPP
PPPTTTTTTTTTTTTTTTTTTTTTTTTTTTTTTTTAAAAAAAPPAAAAPMSSSSSSSMPAAAAAAAAAAAAATTAAAAAAAAPPAAAPPTTTTKTPPPPP
PPPTTTTTTTTTTTTTTTTTTTTTTTTTTTTTPTTAAAAAAAAPPAAAPMMMMMMMMMPAAAAAAAAAAAAAATTAAAAAAAAPPAPPATTTTTTPPPPP
PPPTTTTTTTTTTTTTTTTTTTTTTTTTTPTPPPTPAAAAAAPPAAAAPPPPPPPPPPPAAAAAAAAAAAAAATTAAAAAAAAAPPPPATTTTTTPPPPP
PPPTTTTTTTTTTTTTTTTTTTTPPTPPPPPPTPPPPPAPAPPAPAAAATTTTTAAPPAAAAAAAAPAAAAATTAAAAAAAAPAAPPAATPPPPPTPPPP
PPPTPTTTTTTTTTTTTTTTTPPPPPPPPTPTTTPAPPAPPAAPPPPAATPTPTAAAPPAAPAPAPPPAAATTAAAAKAAAPPPPPTPTPPPPPPPPPPP
PPPPPPTTAPAAAAPPPATTPPPTTPTTTTTTTTTAAAPAPPPPAPPPAPPPPPTTTPPTPPPPPPTPPAAAPAAPPPPPPPAPTPPPPPTTTTTPTPPP
PPPPTPPTPPPAAPPPPPPPPTTTTTTTTTTTTTTAAAAAAPPAAAAPPPTPTPPPTPPPPTPTPTTTPPPPPPPPPPPPPAAAPPTTPTTTTTTTTPPP
PPPPTPPPPPPAAPPAAPPPTTTTTTTTTTTTTTTAAAAAPPAAAAAAPTTTTTPPPPTPTTTTTPTPPPPPAPPPAAAAAAAATPTTTTTTTTTTTPPP
PPPPPPTPAPAAAAPPAATTTTTTTTTTTTTTTTTAAAAAAAAAAAAAATTTTTTPPTTTTTTTPPPPPAAATTAPPAAAPAAAPPPTTTPPTTTTTPPP
PPPTPTTTAAAAAAAPPPTTTTTTTTTTTTTTPTTAAAAAPPAAAAAAATTTTTTTPPTTTTTPPTPTAAAAATTAPPAPPPAPPTPPPPPPPTTTTPPP
PPPTTTTTAAAAAAAAPPPTTTTTTTTPPTPPPPTAAAAAAPPAAAAAATTTTTPTPPTTTPPPTTTTTTTTTTTTTPPPTPPPPPTPPPTTPPTTTPPP
PPPTTTTTAAAAAAAAAAPPTPPPTTPPPPPPTPPAAAAAPPAAAAAAATTTTPPPTPPTPPPPTTTTTTTTTTTTTTPTTTPTTPPTTTTTTPPTPPPP
PPPTTTTTAAAAAAAAAATPPPPPPPPTTPTTTTPPAAAAAPPAPPAAAPTTPPTPPPPPPPPPPPTTTPPPTTPPTPPTPPTTTPPTPTTPPTPPPPPP
PPPTTTTTAAAAAAAAAATTPTTTPPTTTTTTTTTPPPPPPPAPPPAPPPPPPPPTPPPPPPPTPPPPPPPPTTPPPPPPPPPPTPPPPPPPPTTPPPPP
PPPTTTTTAAAAAAAAAATTTTTTTTTTTTTTTTTTPPPPTPAATTPPPTPPTPPPTPPPPTTTTTPPPTTTTTTTPTTPTTPPPPPPTPPTTTTTPPPP
PPPTTTTTTTTTTTTTTTTTTTTTTTTTTTTTTTTTTTTTTAAAAAATTTTTTTTPPPTPTTTTTTTTTTTTTTTTTTTTTTTTPPPTTTTTTTTTTPPP
PPPTKTTTTTTTTTTTTTTTTTTTTTTTTTTTTTTTTTTTTAAAAATTTTTTTTTPPTTTTTTTTTTTTTTTTTTTTTTTTTTTTTPPTTTTTTTTTPPP
PPPTTTTTTTTTTTTTTTTTTTTTTKTTTTTTTTTTTTTTTAPPPAAAAAAAAAAAPPTTTTTTTTTTTTTTTTTTTTTTTTTTTPPPPTTTTTTTTPPP
PPPTPTTTTTTTTTTTTTTTTTTTTTTTTTTTTTTTTTTTTPPAAAAAAAAAAAAPPTTTTTTTTTTTTTTTTTTTTTTTTTTTTTPPTTTTTTTTTPPP
PPPPPPPTTTTTTTTTTTTTTTTTTTTTTTTTTTTTTTTTPPPPAAAAAAAAAAAAPPTTTTTTTTTTTTTTTTTTTTTTTTTTTPPTTTTTTTTTTPPP
PPPPTPPPTPTPTTTTTTTTTTTTTTTTTTTTPTTTTTPPPKPPAAAKAAAAAAAPPTTTTTTTTTTTTTTTTTTTTTTTTTTTPPPPTTTTTTTTTPPP
PPPTTTTPPPPPPTTPPPSPPPPPPPPPTTTPPPPTPPPPTPPAAAAAAAAAAAAPPTKTTTTTTTTTTTTTTTTTTTTTTTTTTPPTTTTTTTTTTPPP
PPPTTTTTPTPTPPPPMMDMMMMMMPPPPPPPTPPPPPTTPPAAAAAAAAAAAAAPPTTTTTTTTTTTTTTTTTTTTTTTTTTTTPPTTTTTTTTTTPPP
PPPTTTTTTTTTTPPPMPSPSPPPMPTTPPPTTTTPTTKPPAAAAAAAAAAAAAAPPTTTTTTTTTTTTTTTTTTTTTTTTTTTTPPTTTTTTTTTTPPP
PPPTTTTTTTTTTTTPMPSPSPPPMPTTTTTTTTTTTTTPPAAAAAAAAAAAAAPPATTTTTTTTTTTTTTTTTTTTTTTTTTTTPPTTTTTTTTTTPPP
PPPTTTTTTTTTTTTPMPSPSPPPMPTTTTTTTTTTTTTTPPAAAAAAAAAAAAAAATTTTTTTTTTTTTTTTTTTTTTTTTTTTTBBTTTTTTTTTPPP
PPPTTTTTTTTTTTTPMSSSSSSSDSTTTTTTTTTTTTTPPAAAAAAAAAAAPPAAATTTTTTTTTTTTTTTTTTKTTTTTTTTTPPTTTTTTTTTTPPP
PPPTTTTTTTTTTTTPMPSSSPPPMPTTTTTTTTTTTTTPPAAAAAAAAAAAAPPAATTTTTTTTTTTTTTTTTTTTTTTTTTTPPTTTTTTTTTTTPPP
PPPTTTTTTTTTTTTPMPPPSPPPMPTTTTTTTTTTTTPPTAAAAAAAAAAAAAPPATTTTTTTTTTTTTTTTTTTTTTTTTTTPPTTTTTTTTTTTPPP
PPPTTTTTTTTTTTTPMPPPSPPPMPTTTTTTTTTTTPPTTKAAAAAKAAAAAPPAATTTTTTTTTTTTTTTTTTTTTTTTTTTTPPTTTTTTTTTTPPP
PPPTTTTTTTTTTTTPMMMMMMMMMPTTTTTTTTTTTPPTTAAAAAAAAAAAAAPPATTTTTTTTTTTTTTTTTTTTTTTTTTTTTPPTTTTTTTTTPPP
PPPTTTTTTTTTTTTPPPPPPPPPPPTTTTTTTTTTPPTTTAAAAAAAAAAAAAPPATTTTTTTTTTTTTTTTTTTTTTTTTTTTPPTTTTTTTTTTPPP
PPPTTTTTTTTTTTTTTTTTTTTTTTTTTTTTTTTTPPTTTAAAAAAAAAAAAPPAATTTTTTTTTTTTTTTTTTTTTTTTTTTTPPTTTTTTTTTTPPP
PPPTTTTTTTTTTTTTTTTTTTTTTTTTTTTTTTTTPPTTTTTTTTTTTTTTPPTTTTTTTTTTTTTTTTTTTTTTTTTTTTTTTPPTTTTTKTTTTPPP
PPPTTTTTTTTTTTTTTTTTTTTTTTTTTTTTTPPSPPPPPPPPTTTTTTTPPTTTTTTTTTTTTTTTTTTTTTTTTTTTTTTTTPPTTTTTTTTTTPPP
PPPTTTTTTTTTTTTTTTTTTTTTTTTTTTTTTPMDMMMMMMMPTTTTTTTTPPTTTTPTTTTTTTTTTTTTTTTTTTTTTTTTTTPPTTTTTTTTTPPP
PPPTPTTTTTTTTTTTTTTTTTTTTTTTTTPPPPMSPPPPPPMPTPTTTPTPTPPPTPPPTPTTTTTTTTTTTTTTTTPPTTTTTPPTTTTTTTTTTPPP
PPPPPPTTTTTTTTTTTTTTTTTTTTPTPPPPPPMSPPPPPPMPPPPTPPPPPPTPPPTPPPPTTTTTTTTTPTTTTPPPPTTTTTPPTTTTTTTTTPPP
PPPPTPPPTTTTTTTTPTTTTTTTTPPPPPTTTPMSPPPPPPMPPTPPPTPPPTTTPTTTPTPPPTPPTTTPPPTTBPTTPPTTTPPPPTTTTPTPTPPP
PPPTTTPPPTTTTPPPPTPTTTTBPPTPTTKTTPMSPPPPPPMPTTTPTTTPPTTTTTTTTTTPPPPPPPPPTPPPBTTTTPPTTTPPPPPAPPPPPPPP
PPPTTTTTPPPTPPPPTPPPPPTBBTTTTTTTTPMSPPPPPPMPTTTTTTPPTTTTTTTTTTTTTPTTPPPTTTPPTTTTTTPPTPPPPPPAPTPTPPPP
PPPTTTTTTPPPPPTTTTPTPPPPTTTTTTTTTPMSPPPPPPMPTTTTTPPTTTTTTTTTTTTTTTTTTTTTTTTTTTTTTTTPPPPPPPTTTTTTTPPP
PPPTTTTTTTTPTTTTTTTTTTPTTTTTTTTTTPMSPPPPPPMPTTTTTPPTTTTTTTTTTTTTTTTTTTTTTTTTTTTTTTTTPTPPPPTTTTTTTPPP
PPPTTTTTTTTTTTTTTTTTTTTTTTTTTTTTTPMMMMMMMMMPTTTTTTPPTTTTTTTTTTTTTTTTTTTTTTTTTTTTTTTTTPPTPPTTTTTTTPPP
PPPTTTTTTTTTTTTTTTTTTTTTTTTTTTTTTPPPPPPPPPPPTTTTTPPTTTTTTTTTTTTTTTTTTTTTTTTTTTTTTTTTPPTPPTTTTTTTTPPP
PPPTTTTTTTTTTTTTTTTKTTTTTTTTTTTTTTTTTTTTTTTTTTTTTTPPTTTTTTTTTTTTTTTTTTTTTTTTTTTTTTTPPTPPTTTTTTTTTPPP
PPPTTTTTTTTTTTTTTTTTTTTTTTTTTTAAAAAAPPAATTTTTTTTTTTPPTTTTTTTTTTTTTTTTTTTTTTTTTTTTTTTTTTTTTTTTTTTTPPP
PPPPPPPPPPPPPPPPPPPPPPPPPPPPPPPPPPPPPPPPPPPPPPPPPPPPPPPPPPPPPPPPPPPPPPPPPPPPPPPPPPPPPPPPPPPPPPPPPPPP
PPPPPPPPPPPPPPPPPPPPPPPPPPPPPPPPPPPPPPPPPPPPPPPPPPPPPPPPPPPPPPPPPPPPPPPPPPPPPPPPPPPPPPPPPPPPPPPPPPPP
PPPPPPPPPPPPPPPPPPPPPPPPPPPPPPPPPPPPPPPPPPPPPPPPPPPPPPPPPPPPPPPPPPPPPPPPPPPPPPPPPPPPPPPPPPPPPPPPPPPP
