100
100
PPPPPPPPPPPPPPPPPPPPPPPPPPPPPPPPPPPPPPPPPPPPPPPPPPPPPPPPPPPPPPPPPPPPPPPPPPPPPPPPPPPPPPPPPPPPPPPPPPPP
PPPPPPPPPPPPPPPPPPPPPPPPPPPPPPPPPPPPPPPPPPPPPPPPPPPPPPPPPPPPPPPPPPPPPPPPPPPPPPPPPPPPPPPPPPPPPPPPPPPP
PPPPPPPPPPPPPPPPPPPPPPPPPPPPPPPPPPPPPPPPPPPPPPPPPPPPPPPPPPPPPPPPPPPPPPPPPPPPPPPPPPPPPPPPPPPPPPPPPPPP
PPPTTTTTTTTTTTTTTTTTTTTTTTSSSSTTTTSSTTTTTTTSSTSSTTTTTTTTTSSTTTTTTTTTTTTTTTTTTTTTAATKTTTTTTTTTTTTKPPP
PPPTTTTTTTTTTTTTTTTTTTTTTTSSTSSTTTSSTTTTTTTSSSSTTTTTTTTTTTSSTTTTTTTTTTTTTTTTTTTAATTTTTTTTTTTTTTTTPPP
PPPSSSTTTTTTTTTTTTTTTTTTTSSTTTSSTSSTTTTTTTSSTSSTTTTTTTTTTTSSTTTTTTTTTTTTTTTTTTAATTTTTTTTTTTTTTTTTPPP
PPPSSSSTTTTTTTTTTTTTTTTTSSTTTTSSTSSTTTTTTTTSSTSSTTTTTTTTTSSTTTTTTTTTTTTTTTTTTTAATTTTTTTTTTTTTTTTTPPP
PPPTTTSSTTTTTTTTTTTTTTTTSSTTTTSSTSSTTTTTTTTTSSSSTTTTTTTTTSSTTTTTTTTTTTTTTTTTTTAATTTTTTTTTTTTTTTTTPPP
PPPTTTTSSTTTTTTTTTTTTTTTTSSTTTSSSSTTTTTTTTTSSSSTTTTTTTTTTSSTTTTTTTTTTTTTTTTTTTTAATTTTTTTTTTTTTTTTPPP
PPPTTTTTSSTTTTTTTTTTTTTTSSTTTSSSSTTTTTTTTTTTSSTTTTTTTKTTSSTTTTTTTTTTTTTTTTTTTTAATTTKTTTTTTTTTTTTTPPP
PPPTTTTTTSSTSSTTTTTTTTTTTSSTTSSTTTTTTTTTTTTTTSSTTTTTTTTTSSTTTTTTTTTTTTTTTTTTTTAATTTTTTTTTTTTTTTTTPPP
PPPTTTTTTTSSSSSSSSTTTTTTTTSSTSSTTTTTTTTTTTTTTSSTTTTTTTTSSTTTTTTTTTTTTTTTTTTTTTAATTTTTTTTTTTTTTTTTPPP
PPPTTTTTTTTSTTSSSSSTTTTTTTTTSSSSTTTTTTTTTTTTSSTTTTTTTTTSSTTTTTTTTTTTTTTTTTTTTAATTTTTTTTTTTTTTTTTTPPP
PPPTTTTTTTTTTTKTTTSSTTTTTTTSSSSTTTTTTTTTTTTSSTTTTTTTTTSSTTTSTTSSTTTTTTTTTTTTAATTTTTTTTTTTTTTTTTTTPPP
PPPTTTTTTTTTTTTTTTTSSSSTTTTTSSTTTTTTTTTTTTSSSSTTTTTTTSSTTTSSSSSSSSSTTTTTTTKTAATSSTTTTSTTTTTTSSSSTPPP
PPPTTTTTTTTTTTTTTTTTSSSSTTSSTSSTTTTTTAAAAASSSSAAAAATSSSTTSSTSSTTSSSSSSTTTTTTAASSSSSSSSTSTTSSSSSSSPPP
PPPTTTTTTTTTTTTTTTTTSTSSSSSSSTSSTTTTTAAASSSAASSAAASSSSSTSSTTSTTTTTTSSSTSTTTSAASTTSSSSTSSTSSSSSTTSPPP
PPPTTTTTTTTTTTTTTTTSSSSSSSSTSSSSTTSSSSSSSSSASAASSSSSSSSSSTTSSSSTTSSTSSSSSTSSTAATTTTTTSSSSSTTSSTTTPPP
PPPSSSTSTTTTTTTTTSSSTSTSTTSSSSSSSSSSSSSSAASSSASSSSASSSSTTTSSTSSSSSSSSSSSSSSTTTAATTTSSSTSSTTTTTTTTPPP
PPPSSSSSSSSTSTTSSSSTTTTTTTTTSSTTSSSTTAAASSSSASSSAASSTTSSSSSTTTTSSTTSTTTSTSSSSTTTSTSSSTTTTTTTTTTTTPPP
PPPTTTSTSSSSSSSSSTTTTTTTTTTSSSSTTTSSSSSSSSASSSSSSSSTTTTSSSTTTTTTTTTTTTTTTTSSSSTSSSSTTTTTTTTTTTTTTPPP
PPPTTTTTTTTSTSSTTTTTTTTTTTTTSSSSKTTSSSSSAAASSASASSATTTSSTTTTTTTTTTTTTTTTTTTTTSSSTSTTTTTTTTTTTTTTTPPP
PPPTTTTTTTTTTTTTTTTTTTTTTTTTSSTSSTTTTAAAAAASSASSAAATTTTSSTTTTTTTTTTTTTTTTTTTTTSAATTTTTTTTTTTTTTTTPPP
PPPTTTTTTTTTTTTTTTTTTTTTTTTTTSSTSSTTTAAAAAASSASSAAATTTTSSTTTTTTTTTTTTTTTTTTTTTAATTTTTTTTTTTTTTTTTPPP
PPPTTTTTTTTTTTTTTTTTSSSSSSSSSSSSSTTTTAAAAAASSSSAAAATTTTSSTTTTTTTTTTTTTTTTTTTTTTAATTTTTTTTTTTTTTTTPPP
PPPTTTTTTTTTTTTTTTTTSMMMMMMMMMSSSTTTTAAAAAAASSSSAAATTTTTSSTTTTTTTTTTTTTTTTTTTTTTAATTTTTTTTTTTTTTTPPP
PPPTTTTTTTTTTTTTTTTTSMSSSSSSSMSTSSTTTAAAAAASSSSAAAATTTTTSSTTTTTTTTTTTTTTTTTTTTTTTAATTTTTTTTTTTTTTPPP
PPPTTTTTTTTTTTTTTTTTSMSSSSSSSMSTTSSTTAAAAAAASSAAAAATTTTTTSSTTTTTTTTTTTTTTTTTTTTTTAATTTTTTTTTTTTTTPPP
PPPTTTTTTTTTTTTTTTTTSMSSSSSSSMSTTTSSTAAAAAAASSAAAAATTTTTSSTTTTTTTTTTTTTTTTTTTTTTTAATTTTTTTTTTTTTTPPP
PPPTTTTTTTTTTTTTTTTTSMSSSSSSSMSTTTSSTTTTTTTTSSTTTTTTTTTTSSTTTTTTTTTTTTTTTTTTTTTTAATTTTTTTTTTTTTTTPPP
PPPTTTTTTTTTTTTTTTTTSMSSSSSSSMSTTTTSSTTTTTTTTSSTTTTTTTTTSSTTTTTTTTTTTTTTTTTTTTTAATTTTTTTTTTTTTTTTPPP
PPPTTTTTTTTTTTTTTTTTSMSSSSSSSMSTTTTTSSTTTTTTSSTTTTTTTTTSSTTTTTTTTTTTTTTTTTTTTTTAATTTTTTTTTTTTTTTTPPP
PPPTTTTTTTTTTTTTTTTTSMSSSSSSSMSTTTTTTSSTTTTTTSSTTTTTTTTTSSTTTTTTTTTTTTTTTTTTTTTTAATTTTTTTTTTTTTTTPPP
PPPTTTTTTTTTTTTTTTTTSMDMMMMMMMSTTTTTTTSSTTTTSSTTTTTTTTTSSTTTTTTTTTTTKTTTTTTKTTTAATTTTTTTTTTTTTTTTPPP
PPPBBBBBBBBBBBBBBBBBBBBBBBBBBBBBBBBBBBBBBBBBBBBBBBBBBBBBBBBBBBBBBBBBBBBBBBBBBBBBBBBBBBBBBBBBBBBBBPPP
PPPBBBBBBBBBBBBBBBBBBBBBBBBBBBBBBBBBBBBBBBBBBBBBBBBBBBBBBBBBBBBBBBBBBBBBBBBBBBBBBBBBBBBBBBBBBBBBBPPP
PPPBBBBBBBBBBBBBBBBBBBBBBBBBBBBBBBBBBBBBBBBBBBBBBBBBBBBBBBBBBBBBBBBBBBBBBBBBBBBBBBBBBBBBBBBBBBBBBPPP
PPPBBBBBBBBBBBBBBBBBBBBBBBBBBBBBBBBBBBBBBBBBBBBBBBBBBBBBBBBBBBBBBBBBBBBBBBBBBBBBBBBBBBBBBBBBBBBBBPPP
PPPBBBBBBBBBBBBBBBBBBBBBBBBBBBBBBBBBBBBBBBBBBBBBBBBBBBBBBBBBBBBBBBBBBBBBBBBBBBBBBBBBBBBBBBBBBBBBBPPP
PPPBBBBBBBBBBBBBBBBBBBBBBBBBBBBBBBBBBBBBBBBBBBBBBBBBBBBBBBBBBBBBBBBBBBBBBBBBBBBBBBBBBBBBBBBBBBBBBPPP
PPPBBBBBBBBBBBBBBBBBBBBBBBBBBBBBBBBBBBBBBBBBBBBBBBBBBBBBBBBBBBBBBBBBBBBBBBBBBBBBBBBBBBBBBBBBBBBBBPPP
PPPBBBBBBBBBBBBBBBBBBBBBBBBBBBBBBBBBBBBBBBBBBBBBBBBBBBBBBBBBBBBBBBBBBBBBBBBBBBBBBBBBBBBBBBBBBBBBBPPP
PPPBBBBBBBBBBBBBBBBBBBBBBBBBBBBBBBBBBBBBBBBBBBBBBBBBBBBBBBBBBBBBBBBBBBBBBBBBBBBBBBBBBBBBBBBBBBBBBPPP
PPPBBBBBBBBBBBBBBBBBBBBBBBBBBBBBBBBBBBBBBBBBBBBBBBBBBBBBBBBBBBBBBBBBBBBBBBBBBBBBBBBBBBBBBBBBBBBBBPPP
PPPBBBBBBBBSSSSSSSSSSSSSSSSSSSSSSSSSSSSSSSSSSSSSSSSSSSSSSSSSSSSSSSSSSSSSSSSSSSSSAASSSSSSSBBBBBBBBPPP
PPPBBBBBBBBSSSSSSSSSSSSSSSSSSSSSSSSSSSSSSSSSSSSSSSSSSSSSSSSSSSSSSSSSSSSSSSSSSSSSAASSSSSSSBBBBBBBBPPP
PPPBBBBBBBBSSSSSSSSSSSSSSSSSSSSSSSSSSSSSSSSSSSSSSSSSSSSSSSSSSSSSSSSSSSSSSSSSSSSSAASSSSSSSBBBBBBBBPPP
PPPBBBBBBBBSSSSSSSSSSSSSSSSSSSSSSSSSSSSSSSSSSSSSSSSSSSSSSSSSSSSSSSSSSSSSSSSSSSSSAASSSSSSSBBBBBBBBPPP
PPPBBBBBBBBBBBBBBBBBBBBBBBBBBBBBBBBBBBBBBBBBBBBBBBBBBBBBBBBBBBBBBBBBBBBBBBBBBBBBBBBBBBBBBBBBBBBBBPPP
PPPBBBBBBBBBBBBBBBBBBBBBBBBBBBBBBBBBBBBBBBBBBBBBBBBBBBBBBBBBBBBBBBBBBBBBBBBBBBBBBBBBBBBBBBBBBBBBBPPP
PPPBBBBBBBBBBBBBBBBBBBBBBBBBBBBBBBBBBBBBBBBBBBBBBBBBBBBBBBBBBBBBBBBBBBBBBBBBBBBBBBBBBBBBBBBBBBBBBPPP
PPPBBBBBBBBBBBBBBBBBBBBBBBBBBBBBBBBBBBBBBBBBBBBBBBBBBBBBBBBBBBBBBBBBBBBBBBBBBBBBBBBBBBBBBBBBBBBBBPPP
PPPBBBBBBBBBBBBBBBBBBBBBBBBBBBBBBBBBBBBBBBBBBBBBBBBBBBBBBBBBBBBBBBBBBBBBBBBBBBBBBBBBBBBBBBBBBBBBBPPP
PPPBBBBBBBBBBBBBBBBBBBBBBBBBBBBBBBBBBBBBBBBBBBBBBBBBBBBBBBBBBBBBBBBBBBBBBBBBBBBBBBBBBBBBBBBBBBBBBPPP
PPPBBBBBBBBBBBBBBBBBBBBBBBBBBBBBBBBBBBBBBBBBBBBBBBBBBBBBBBBBBBBBBBBBBBBBBBBBBBBBBBBBBBBBBBBBBBBBBPPP
PPPBBBBBBBBBBBBBBBBBBBBBBBBBBBBBBBBBBBBBBBBBBBBBBBBBBBBBBBBBBBBBBBBBBBBBBBBBBBBBBBBBBBBBBBBBBBBBBPPP
PPPBBBBBBBBBSSSSSSSSSSSSSSSSSSSSSSSSSSSSSSSSSSSSSSSSSSSAASSSSSSSSSSSSSSSSSSSBBBBBBBBBBBBBBBBBBBBBPPP
PPPBBBBBBBBBBBBBBBBBBBBBBBBBBBSSSSSSSSSSSSSSSSAAAAAAAAAAAAAAAAAAASSSSSSSSSSSSSSSSSSSSSSBBBBBBBBBBPPP
PPPBBBBBBBBBSSSSSSSSSSSSSSSSSSSSSSSSSSSSSSSSSSSSSSSSSSSAASSSSSSSSSSSSSSSSSSSBBBBBBBBBBBBBBBBBBBBBPPP
PPPBBBBBBBBBBBBBBBBBBBBBBBBBBBSSSSSSSSSSSSSSSSAAAAAAAAAAAAAAAAAAASSSSSSSSSSSSSSSSSSSSSSBBBBBBBBBBPPP
PPPBBBBBBBBBSSSSSSSSSSSSSSSSSSSSSSSSSSSSSSSSSSSSSSSSSSSAASSSSSSSSSSSSSSSSSSSBBBBBBBBBBBBBBBBBBBBBPPP
PPPBBBBBBBBBBBBBBBBBBBBBBBBBBBSSSSSSSSSSSSSSSSAAAAAAAAAAAAAAAAAAASSSSSSSSSSSSSSSSSSSSSSBBBBBBBBBBPPP
PPPBBBBBBBBBSSSSSSSSSSSSSSSSSSSSSSSSSSSSSSSSSSSSSSSSSSSAASSSSSSSSSSSSSSSSSSSBBBBBBBBBBBBBBBBBBBBBPPP
PPPBBBBBBBBBBBBBBBBBBBBBBBBBBBSSSSSSSSSSSSSSSSAAAAAAAAAAAAAAAAAAASSSSSSSSSSSSSSSSSSSSSSBBBBBBBBBBPPP
PPPBBBBBBBBBSSSSSSSSSSSSSSSSSSSSSSSSSSSSSSSSSSSSSSSSSSSAASSSSSSSSSSSSSSSSSSSBBBBBBBBBBBBBBBBBBBBBPPP
PPPBBBBBBBBBBBBBBBBBBBBBBBBBBBSSSSSSSSSSSSSSSSAAAAAAAAAAAAAAAAAAASSSSSSSSSSSSSSSSSSSSSSBBBBBBBBBBPPP
PPPBBBBBBBBBSSSSSSSSSSSSSSSSSSSSSSSSSSSSSSSSSSSSSSSSSSSAASSSSSSSSSSSSSSSSSSSBBBBBBBBBBBBBBBBBBBBBPPP
PPPBBBBBBBBBBBBBBBBBBBBBBBBBBBSSSSSSSSSSSSSSSSAAAAAAAAAAAAAAAAAAASSSSSSSSSSSSSSSSSSSSSSBBBBBBBBBBPPP
PPPBBBBBBBBBSSSSSSSSSSSSSSSSSSSSSSSSSSSSSSSSSSSSSSSSSSSAASSSSSSSSSSSSSSSSSSSBBBBBBBBBBBBBBBBBBBBBPPP
PPPBBBBBBBBBBBBBBBBBBBBBBBBBBBBBBBBBBBBBBBBBBBBBBBBBBBBBBBBBBBBBBBBBBBBBBBBBBBBBBBBBBBBBBBBBBBBBBPPP
PPPBBBBBBBBBBBBBBBBBBBBBBBBBBBBBBBBBBBBBBBBBBBBBBBBBBBBBBBBBBBBBBBBBBBBBBBBBBBBBBBBBBBBBBBBBBBBBBPPP
PPPBBBBBBBBBBBBBBBBBBBBBBBBBBBBBBBBBBBBBBBBBBBBBBBBBBBBBBBBBBBBBBBBBBBBBBBBBBBBBBBBBBBBBBBBBBBBBBPPP
PPPBBBBBBBBBBBBBBBBBBBBBBBBBBBBBBBBBBBBBBBBBBBBBBBBBBBBBBBBBBBBBBBBBBBBBBBBBBBBBBBBBBBBBBBBBBBBBBPPP
PPPBBBBBBBBBBBBBBBBBBBBBBBBBBBBBBBBBBBBBBBBBBBBBBBBBBBBBBBBBBBBBBBBBBBBBBBBBBBBBBBBBBBBBBBBBBBBBBPPP
PPPBBBBBBBBBBBBBBBBBBBBBBBBBBBBBBBBBBBBBBBBBBBBBBBBBBBBBBBBBBBBBBBBBBBBBBBBBBBBBBBBBBBBBBBBBBBBBBPPP
PPPBBBBBBBBBBBBBBBBBBBBBBBBBBBBBBBBBBBBBBBBBBBBBBBBBBBBBBBBBBBBBBBBBBBBBBBBBBBBBBBBBBBBBBBBBBBBBBPPP
PPPBBBBBBBBBBBBBBBBBBBBBBBBBBBBBBBBBBBBBBBBBBBBBBBBBBBBBBBBBBBBBBBBBBBBBBBBBBBBBBBBBBBBBBBBBBBBBBPPP
PPPBBBBBBBBBBBBBBBBBBBBBBBBBBBBBBBBBBBBBBBBBBBBBBBBBBBBBBBBBBBBBBBBBBBBBBBBBBBBBBBBBBBBBBBBBBBBBBPPP
PPPBBBBBBBBBBBBBBBBBBBBBBBBBBBBBBBBBBBBBBBBBBBBBBBBBBBBBBBBBBBBBBBBBBBBBBBBBBBBBBBBBBBBBBBBBBBBBBPPP
PPPBBBBBBBBBBBBBBBBBBBBBBBBBBBBBBBBBBBBBBBBBBBBBBBBBBBBBBBMMMMMMMMMBBBBBBBBBBBBBBBBBBBBBBBBBBBBBBPPP
PPPSTSTTTTTSTTSTTTTTTTTTBSSSSBSBBSSTTTTSSTTTTTTTTTSTTTTTTSMSSSSSSSMSTTTTTTTTAATTTTTTTTTTTTTTTTTTTPPP
PPPSSSSTSTSSSSSSTTTTTTTSSSBSSBBBSSTTTTSSTTTTTTTTTSSTTTTTTSMSSSSSSSMSTTTTTTTTTAATTTTTTTTTTTTTTTTTTPPP
PPPTSTSSSSSTSSTSSSSTSSSSSBBBSSBBBSSTTTSSTTTTTTTTTTSSTTTTTSMSSSSSSSMSTTTTTTTTTTAATTTTTTTTTTTTTTTTTPPP
PPPTTTTSTSSSTTTTSSSSSSSTBBBSSBBBSSTTTTSSTTTTTTTTTSSTTTTTTSMSSSSSSSMSTTTTTTTTTAATTTTTTTTTTTTTTTTTTPPP
PPPTTTTTTTSSSTTTTTTSTTTTBBBSSBBBBSSTTTTSSTTTTTTTSSTTTTTTTSMSSSSSSSMSTTTTTTTTTAATTTTTTTTTTTTTTTTTTPPP
PPPTTTTTTTTTSSSTTTTTTTTTBBSSBBBBSSTTTTTTSSTTTTTTSSTTTTTTTSMSSSSSSSMSTTTTTTTTTTAATTTTTTTTTTTTTTTTTPPP
PPPTTTTTTTTTTSSSTTTTTTTTTTTSSTTSSSSTTTTTSSTTTTTTSSTTTTTTTSMMDMMMMMMSTTTTTTTTTTAATTTTSSSSSSSSSSSTTPPP
PPPTTTTTTTTTTTTSSSTTTTTTTTTTSSSSTTSSTTTTTSSTTTTTSSTTTTTTTSSSSSSSSSSSTTTTTTTTTAATTTTTSMMMMMMMMMSTTPPP
PPPTTTTTTTTTTTTTTTTSSTSTSSSSSSSTTSTSSSSSSSSSTTSTSSTSTTTTSSTTTTTTTTTTTTTTTTTTTAATTTTTSMSSSSSSSMSTTPPP
PPPTTTTTTTTTTTTTTTTTTTTTTSTTSSSSSSSSTTSSTTSTTTTSSSSSSTTTSSTTTTTTTTTTTTTTTTTTTAATTTTTSMSSSSSSSMSTTPPP
PPPTTTTTTTTTTTTTTTTTTTTTTTTTTTTSSTSTTTTTTTSSTTTSSTSTSSSSTSSTSTTTTTTTTTTTTTTTTTAATKTTSMSSSSSSSMSTTPPP
PPPTTTTTTTTTTTBBBBBBBBBBBBTTTTSSSSTTTTTTTSSTTTSSTTTTTSSSSTSSSSSSTSTSTTTTTTTTTAATTTTTSMSSSSSSSMSTTPPP
PPPTTTTKTTTTTTBBBBBBBBBBBBTTTSSSSTTTTTTTTTSSTTSSTTTTTTTTSSSSTSSSSSSSSSSTTTTTAATTTTTTSDSSSSSSSMSTTPPP
PPPTTBBBBBBBBBBBBBBBBBBBBBTTTTSSSSTTTTTTTSSTTTSSTTTTTTTTTSSSTTTTSTSTSSSSTTTAATTTTTTTSMMMMMMMMMSTTPPP
PPPTTBBBBBBBBBBBBBBBBBBBBBTTTSSSSTTTTTTTTTSSTSSTTTTTTTTTTTSSTTTTTTTTTTTSSSTAATTTTTTTSSSSSSSSSSSTTPPP
PPPPPPPPPPPPPPPPPPPPPPPPPPPPPPPPPPPPPPPPPPPPPPPPPPPPPPPPPPPPPPPPPPPPPPPPPPPPPPPPPPPPPPPPPPPPPPPPPPPP
PPPPPPPPPPPPPPPPPPPPPPPPPPPPPPPPPPPPPPPPPPPPPPPPPPPPPPPPPPPPPPPPPPPPPPPPPPPPPPPPPPPPPPPPPPPPPPPPPPPP
PPPPPPPPPPPPPPPPPPPPPPPPPPPPPPPPPPPPPPPPPPPPPPPPPPPPPPPPPPPPPPPPPPPPPPPPPPPPPPPPPPPPPPPPPPPPPPPPPPPP
