100
100
PPPPPPPPPPPPPPPPPPPPPPPPPPPPPPPPPPPPPPPPPPPPPPPPPPPPPPPPPPPPPPPPPPPPPPPPPPPPPPPPPPPPPPPPPPPPPPPPPPPP
PPPPPPPPPPPPPPPPPPPPPPPPPPPPPPPPPPPPPPPPPPPPPPPPPPPPPPPPPPPPPPPPPPPPPPPPPPPPPPPPPPPPPPPPPPPPPPPPPPPP
PPPPPPPPPPPPPPPPPPPPPPPPPPPPPPPPPPPPPPPPPPPPPPPPPPPPPPPPPPPPPPPPPPPPPPPPPPPPPPPPPPPPPPPPPPPPPPPPPPPP
PPPBBBBBBBBBBBBBBBBBBBBBBBBBBBBBBBBBBBSSBBBBBBBBBBSSBBBBSSBBBBBBBBBBBBBBBBBBBBSSBBBBBSSBBBKBSSBSSPPP
PPPBBBBBBBBBBBBBBBBBBBBBBBBBSBBBBBBBBBBSSBBBBBBBBSSSSBSSSSBBBBBBBBBBBBBBBBBBBBSSBBBBBSSBBBBSSBSSBPPP
PPPBBBBBBBBBBBBBBBBBBBBBBBSSSSBBBBBBBBBSSBBBBBBBBSSSSSSSBBBBBBBBBBBBBBBBBBBBBSSBBBBBSSBBBBBBSSBBBPPP
PPPBBBBBBBBBBBBBBBBBBBBBSSSSBSSSSBBBSBSSSBSBSSBSSSSBBSBBBBBBBBBBBBBBBBBBBBBBBBSSBBBBSSBBBBBBBSSBBPPP
PPPBBBBBBBBBBBBBBBBBBBBSSSBBBBSSSSSSSSSSBSSSSSSSSBSSBBBBBBBBBBBBBBBBBBBBBBBBBBSSBBBBBSSBBBBBBSSBBPPP
PPPBBBBBBBBBBBSBBBBBBSSSBBBBBBBBBSSSBSBSSSBSBBSBBSSBBBBBBBBBBBBBBBBBBBBBBBBBBBBSSBBBSSBBBBBBBSSBBPPP
PPPBBBBBBBBBBSSSBSSSSSSBBBBBBBBBBBBBBBBBSBBBBBBBBBSSBBBBBBBBBBBBBBBBBBBBBBBBBBBSSBBSSBBBBBBBBBSSBPPP
PPPBBBSSBBBBSSBSSSSSSBBBBBBBBBBBBBBBBBBBSSBBBBBBBBBSSBBBBBBBBBBBBBBBBBBBBBBBBBBBSSBSSBBBBBBBBSSSSPPP
PPPSBSSSSBSSSBBBSBBBBBBBBBBBBBBBBBBBBBBBSSBBBBBBBBBSSBBBBBBBBBBBBBBBBBBBBBBBBBBBSSBBSSBBBBBBBBSSBPPP
PPPSSSBBSSSSBBBBBBBBBBBBBBBBBBBBBBBBBBBBSSBBBBBBBBSSBBBBBBBBBBBBBBBBBBBBBBBBBBBBBSSSSSSSSSSSSSSSBPPP
PPPBSBBBBSBBBBBBBBBBBBBBBBBBBBBBBBBBBBBBBSSBBBBBBBBSSBBBBBBBBBBBBBBBBBBBBBBBBBBBSSBSSSMMMMMMMMMSBPPP
PPPBBBBBBBBBBBBBBBBBBBBBBBBBBBBBBBBBBBBBBBSSBBBBBBBSSBBBBBBBBBBBBBBBBBBBBBBBBBBSSBBBBSMSSSSSSSMSBPPP
PPPBBBBBBBBBBBBBBBBBBBBBBBBBBBBBBBBBBBBBBBSSBBBBBBSSBBBBBBBBBBBBBBBKBBBBBBBBBBBBBBBBBSMSSSSSSSMSBPPP
PPPBBBBBBBBBBBBBBBBBBBBBBBBBBBBBBBBBBBBBBBBSSBBBBBSSBBBBBBBBBBBBBBBBBBBBBBBBBBBBBBBBBSMSSSSSSSMSBPPP
PPPBBBBBBBBBBBBBBBBBBBBBBBBBBBBBBBBBBBBBBBBSSBBBBBSSBBBBBBBBBBBBBBBBBBBBBBBBBBBSSBBBBSMSSSSSSSMSBPPP
PPPBBBBBBBBBBBBBBBBBBBBBBBBBBBBBBBBBBBBBBBSSBBBBBBSSBBBBBBBBBBBBBBBBBBBBBBBBBBBBSSBBBSMSSSSSSSDSBPPP
PPPBBBBBBKBBBBBBBBBBBBBBBBBBBBBBBBBBBBBBBBSSBBBBBBBSSBBBBBBBBBBBBBBBBBBBBBBBBBBBBSSBBSMSSSSSSSMSBPPP
PPPBBBBBBBBBBBBBBBBBBBBBBBBBBBBBBBBBBBBBBSSBBBBBBBBSSBBBBBBBBBBBBBBBBBBBBBBBBBBBBSSBBSMSSSSSSSMSBPPP
PPPBBBBBBBBBBBBBBBBBBBBBBBBBBBBBBBBBBBBBKBSSBBBBBBBBSSBBBBBBBBBBBBBBBBBBBBBBBBBBSSBBBSMMMMMMMMMSBPPP
PPPBBBBBBBBBBKTTTTTTTKBBBBBBBBBBBBBBBBBBBBBSSBBBBBBSSBBBBBBBBBBBBBBBBBBBBBBBBBBBBSSBBSSSSSSSSSSSBPPP
PPPKBBBBBBBBBTTTTTTTTTBBBBBBBBBBBBBBBBBBBBSSBBBBBBSSBBBBBBBBBBBBBBBBBBBBBBBBBBBBBSSBSSBBBBBBBBSSBPPP
PPPBBBBBBBBBBTTTTTTTTTBBBBBBBBBBBBBBBBBBBBBSSBBBBBBSSBBBBBBBBBBBBBBBBBBBBBBSSSSSSSSSSSBBBBBBBSSBBPPP
PPPBBBBBBBBBBTTTTTTTTTBBBBBBBBBBBBBBBBBBBBBSSBBBBBBSSBBBBBBBBBBBBBBBBBBBBBBSMMMMMMMMMSBBBBBBBSSBBPPP
PPPBBBBBBBBBBTTTTTTTTTBBBBBBBBBBBBBBBBBBBBBBSSBBBBBSSBBBBBBBBBBBBBBBBBBBBBBSMSSSSSSSDSBBBBBBBBSSBPPP
PPPBBBBBBBBBBTTTTTTTTTBBBBBBBBBBBBBBBBBBBBBBBSSBBBBSSBBBBBBBBBBBBBBBBBBBBBBSMSSSSSSSMSBBBBBBBBSSBPPP
PPPBBBBBBBBBBTTTTTTTTTBBBBKBBBBBBBBBBBBBBBBBBBSSBBBSSBBBBBBBBBBBBBBBBBBBBBBSMSSSSSSSMSBBBBBBBSSBBPPP
PPPBBBBBBBBBBTTTTTTTTTBBBBBBBBBBKBBBBBBBBBBBBSSBBBSSBBBBBBBBBBBBBBBBBBBBBBBSMSSSSSSSMSBBBBBBBBSSBPPP
PPPBBBBKBBBBBTTTTTTTTTBBBBBBBBBBBBBBBBBBBBBBBSSBBBSSBBBBBBBBBBBBBBBBBBBBBBBSMSSSSSSSMSBBBBBSBBSSBPPP
PPPBBBBBBBBBBTTTTTTTTTBBBBBBBBBBBBBBBBBBBBBBBSSBBBBSSBBBBBBBBBBBBBBBBBBBBBBSMSSSSSSSMSBBBSSSSSSSSPPP
PPPBBBBBBBBBBTTTTTTTTTBBBBBBBBBBBBBBBBBBBBBBBSSBBBBBSSBBBBBBBBBBBBBBBBBBBBBSMSSSSSSSMSBBSSSBSSSBBPPP
PPPBBBBBBBBBBTTTTTTTTTBBBBBBBBBBBBBBBBBBBBBBBBSSBBBBBSSBBBBBBBBBBBBBBBBSKSSSMMMMMMMMMSSSSBBBBSSBBPPP
PPPBBBBBBBBBBTTTTTTTTTBBBBBBBBBBBBBBBBBBBBBBBSSBBBBBBSSBBBBBBBBBBBBBBSSSSSSSSSSSSSSSSSSSBBBBSSBBBPPP
PPPSSBBBBSSSBKTTTTTTTKBBBBBBBBBBBBBBBBBBBBBBBSSBBBBBBBSSBBBBBBBBBBBBSSSBSBBBBBBBBBSSSSBBBBBBBSSBBPPP
PPPSSSBBSSSSSSSSSSSBBSSBBBBBBBSBBBBBBBBBBBBBSSBBBBBBBSSBBBBBBBBBBBBSSBBBBBBBBBBBBBSSSSBBBBBBBSSBBPPP
PPPBBSSSSBBBSBBSSSSSSSSSSSBSSSSSSBSBBBBBBBBBSSSBBBBBBBSSBBBBBBBBSBSSBBBBBBBBBBBBBSSBBSSBBBBBBBSSBPPP
PPPBBBSSBBBBBBBBBBBSSBBSSSSSSSBSSSSSSBSBSBBSSSSSBBBBBBBSSBBBSBBSSSSBBBBBBBBBBBBBBBSSSSBBBBBBBSSBBPPP
PPPBBBBBBBBBBBBBBBBBBBBBBBSBBBBBBSBSSSSSSSSSSSBSSSSSSBSSBBSSSSSSBSBBBBBBBBBBBBBBBBBBSSBBBBBBBSSBBPPP
PPPBBBBBBBBBBBBBBBBBBBBBBBBBBBBBBBBBBSBSBSSSSBBBSSSSSSSSBSSSBSSBBBBBBBBBBBBBBBBBBBBSSSSBBBBBSSBBBPPP
PPPBBBBBBBBBBBBBBBBBBBBBBBBBBBBBBBBBBBBBBBSSBBBBBBBBBSASSSAAAAAAAAAABBBBBBBBBBBBBBBBSSBBBBBBBSSBBPPP
PPPBBBBBBBBBBBBBBBBBBBBBBBBBBBBBBBBBBBBBBSSBBBBBSSSSSSSSSSSAAAAAAAAABBBBBBBKBAAAAAAASSAAABBBBBSSBPPP
PPPBBBBBBBBBBBBBBBBBBBBBBBBBBBBBBBBBBBBBBBSSBBBBSMMMMMMDMMSAAAAAAAAABBBBBBBBBAAAAAAASSAAABBBBSSBBPPP
PPPBBBBBBBBBBBBBBBBBBBBBBBBBBBBBBBBBBBBBBBBSSBBBSMSSSSSSSMSAAAAAAAAAAABBAAAAAAAAAAASSSSAABBBSSBBBPPP
PPPBBBBBBBBBBBBBBBBBBBBBBBBBBBBBBBBBBBBBBBSSBBBBSMSSSSSSSMSAAAAAAAAAAAABBAAAAAAAAAASSASSABBSSBBBBPPP
PPPBBBBBBBBBBBBBBBBBBBBBBBBBBBBBBBBBBBBBBSSKBBBBSMSSSSSSSMSAAAAAAAAAAAABBAAAAAAAAASSAAASSBBBSSBBBPPP
PPPBBBBBBBBBBBBBBBBBBBBBBBBBBBBBBBBBBBBBBBSSBBBBSMSSSSSSSMSAAAAAAAAAAAAABBAAAAAAAAASSAASSBBBSSBBBPPP
PPPBBBBBBBBBBBBBBBBBBBBBBBBBBBBBBBBBBBBBBBBSSBBBSMSSSSSSSMSAAAAAAAAAAAAABBAAAAAAAASSAAASSBBBBSSBBPPP
PPPBBBBBBBBBBBBBBBBBBBBBBBBBBBBBBBBBBBBBBBBSSBBBSMSSSSSSSMSAAAAAAAAAAAABBAAAAAAAAASSAAASSBBBBBSSBPPP
PPPBBBBBBBBBBBBBBBBBBBBBBBBBBBBBBBBAAAAAAASSAAAASMSSSSSSSMSAAAAAAAAAAAAABBAAAAAAAASSAAASSBBBBKBSSPPP
PPPBBBBBBBBBBBBBBBBBBBBBBBBBBBBBSBBAAAAAAAASSAAASMMMMMMMMMSAAAAAAAAAAAAAABBAAAAAAAASSASSABBBBBBSSPPP
PPPBBBBBBBBBBBBBBBBBBBBBBBBBBSBSSSBSAAAAAASSAAAASSSSSSSSSSSAAAAAAAAAAAAAABBAAAAAAAAASSSSABBBBBBSSPPP
PPPBBBBBBBBBBBBBBBBBBBBSSBSSSSSSBSSSSSASASSASAAAABBBBBAASSAAAAAAAASAAAAABBAAAAAAAASAASSAABSSSSSBSPPP
PPPBSBBBBBBBBBBBBBBBBSSSSSSSSBSBBBSASSSSSAASSSSAABSBSBAAASSAASASASSSAAABBAAAAKAAASSSSSBSBSSSSSSSSPPP
PPPSSSBBASAAAASSSABBSSSBBSBBBBBBBBBAAASASSSSASSSASSSSSBBBSSBSSSSSSBSSAAASAASSSSSSSASBSSSSSBBBBBSBPPP
PPPSBSSBSSSSSSSSSSSSSBBBBBBBBBBBBBBAAAAAASSAAAASSSBSBSSSBSSSSBSBSBBBSSSSSSSSSSSSSAAASSBBSBBBBBBBBPPP
PPPSBSSSSSSSSSSAASSSBBBBBBBBBBBBBBBAAAAASSAAAAAASBBBBBSSSSBSBBBBBSBSSSSSASSSAAAAAAAABSBBBBBBBBBBBPPP
PPPSSSBSASAAAASSAABBBBBBBBBBBBBBBBBAAAASSAAAAAAAABBBBBBSSBBBBBBBSSSSSAAABBASSAAASAAASSSBBBSSBBBBBPPP
PPPBSBBBAAAAAAASSSBBBBBBBBBBBBBBSBBAAAAASSAAAAAAABBBBBBBSSBBBBBSSBSBAAAAABBASSASSSASSBSSSSSSSBBBBPPP
PPPBBBBBAAAAAAAASSSBBBBBBBBSSBSSSSBAAAAAASSAAAAAABBBBBSBSSBBBSSSBBBBBBBBBBBBBSSSBSSSSSBSSSBBSSBBBPPP
PPPBBBBBAAAAAAAAAASSBSSSBBSSSSSSBSSAAAAASSAAAAAAABBBBSSSBSSBSSSSBBBBBBBBBBBBBBSBBBSBBSSBBBBBBSSBSPPP
PPPBBBBBAAAAAAAAAABSSSSSSSSBBSBBBBSSAAAAASSASSAAASBBSSBSSSSSSSSSSSBBBSSSBBSSBSSBSSBBBSSBSBBSSBSSSPPP
PPPBBBBBAAAAAAAAAABBSBBBSSBBBBBBBBBSSSSSSSASSSASSSSSSSSBSSSSSSSBSSSSSSSSBBSSSSSSSSSSBSSSSSSSSBBSSPPP
PPPBBBBBAAAAAAAAAABBBBBBBBBBBBBBBBBBSSSSBSSSBBSSSBSSBSSSBSSSSBBBBBSSSBBBBBBBSBBSBBSSSSSSBSSBBBBBSPPP
PPPBBBBBBBBBBBBBBBBBBBBBBBBBBBBBBBBBBBBBBSSBBSSBBBBBBBBSSSBSBBBBBBBBBBBBBBBBBBBBBBBBSSSBBBBBBBBBBPPP
PPPBKBBBBBBBBBBBBBBBBBBBBBBBBBBBBBBBBBBBBSSSSSBBBBBBBBBSSBBBBBBBBBBBBBBBBBBBBBBBBBBBBBSSBBBBBBBBBPPP
PPPBBBBBBBBBBBBBBBBBBBBBBKBBBBBBBBBBBBBBBASSSAAAAAAAAAAASSBBBBBBBBBBBBBBBBBBBBBBBBBBBSSSSBBBBBBBBPPP
PPPBSBBBBBBBBBBBBBBBBBBBBBBBBBBBBBBBBBBBBSSAAAAAAAAAAAASSBBBBBBBBBBBBBBBBBBBBBBBBBBBBBSSBBBBBBBBBPPP
PPPSSSSBBBBBBBBBBBBBBBBBBBBBBBBBBBBBBBBBSSSSAAAAAAAAAAAASSBBBBBBBBBBBBBBBBBBBBBBBBBBBSSBBBBBBBBBBPPP
PPPSBSSSBSBSBBBBBBBBBBBBBBBBBBBBSBBBBBSSSKSSAAAKAAAAAAASSBBBBBBBBBBBBBBBBBBBBBBBBBBBSSSSBBBBBBBBBPPP
PPPBBBBSSSSSSBBSSSSSSSSSSSSSBBBSSSSBSSSSBSSAAAAAAAAAAAASSBKBBBBBBBBBBBBBBBBBBBBBBBBBBSSBBBBBBBBBBPPP
PPPBBBBBSBSBSSSSMMMMMMMMMSSSSSSSBSSSSSBBSSAAAAAAAAAAAAASSBBBBBBBBBBBBBBBBBBBBBBBBBBBBSSBBBBBBBBBBPPP
PPPBBBBBBBBBBSSSMSSSSSSSMSBBSSSBBBBSBBKSSAAAAAAAAAAAAAASSBBBBBBBBBBBBBBBBBBBBBBBBBBBBSSBBBBBBBBBBPPP
PPPBBBBBBBBBBBBSMSSSSSSSMSBBBBBBBBBBBBBSSAAAAAAAAAAAAASSABBBBBBBBBBBBBBBBBBBBBBBBBBBBSSBBBBBBBBBBPPP
PPPBBBBBBBBBBBBSMSSSSSSSMSBBBBBBBBBBBBBBSSAAAAAAAAAAASSAABBBBBBBBBBBBBBBBBBBBBBBBBBBBBSSBBBBBBBBBPPP
PPPBBBBBBBBBBBBSMSSSSSSSDSBBBBBBBBBBBBBSSAAAAAAAAAAASSAAABBBBBBBBBBBBBBBBBBKBBBBBBBBBSSBBBBBBBBBBPPP
PPPBBBBBBBBBBBBSMSSSSSSSMSBBBBBBBBBBBBBSSAAAAAAAAAAAASSAABBBBBBBBBBBBBBBBBBBBBBBBBBBSSBBBBBBBBBBBPPP
PPPBBBBBBBBBBBBSMSSSSSSSMSBBBBBBBBBBBBSSBAAAAAAAAAAAAASSABBBBBBBBBBBBBBBBBBBBBBBBBBBSSBBBBBBBBBBBPPP
PPPBBBBBBBBBBBBSMSSSSSSSMSBBBBBBBBBBBSSBBKAAAAAKAAAAASSAABBBBBBBBBBBBBBBBBBBBBBBBBBBBSSBBBBBBBBBBPPP
PPPBBBBBBBBBBBBSMMMMMMMMMSBBBBBBBBBBBSSBBAAAAAAAAAAAAASSABBBBBBBBBBBBBBBBBBBBBBBBBBBBBSSBBBBBBBBBPPP
PPPBBBBBBBBBBBBSSSSSSSSSSSBBBBBBBBBBSSBBBAAAAAAAAAAAAASSABBBBBBBBBBBBBBBBBBBBBBBBBBBBSSBBBBBBBBBBPPP
PPPBBBBBBBBBBBBBBBBBBBBBBBBBBBBBBBBBSSBBBAAAAAAAAAAAASSAABBBBBBBBBBBBBBBBBBBBBBBBBBBBSSBBBBBBBBBBPPP
PPPBBBBBBBBBBBBBBBBBBBBBBBBBBBBBBBBBSSBBBBBBBBBBBBBBSSBBBBBBBBBBBBBBBBBBBBBBBBBBBBBBBSSBBBBBKBBBBPPP
PPPBBBBBBBBBBBBBBBBBBBBBBBBBBBBBBSSSSSSSSSSSBBBBBBBSSBBBBBBBBBBBBBBBBBBBBBBBBBBBBBBBBSSBBBBBBBBBBPPP
PPPBBBBBBBBBBBBBBBBBBBBBBBBBBBBBBSMDMMMMMMMSBBBBBBBBSSBBBBSBBBBBBBBBBBBBBBBBBBBBBBBBBBSSBBBBBBBBBPPP
PPPBSBBBBBBBBBBBBBBBBBBBBBBBBBSSSSMSSSSSSSMSBSBBBSBSBSSSBSSSBSBBBBBBBBBBBBBBBBSSBBBBBSSBBBBBBBBBBPPP
PPPSSSBBBBBBBBBBBBBBBBBBBBSBSSSSSSMSSSSSSSMSSSSBSSSSSSBSSSBSSSSBBBBBBBBBSBBBBSSSSBBBBBSSBBBBBBBBBPPP
PPPSBSSSBBBBBBBBSBBBBBBBBSSSSSBBBSMSSSSSSSMSSBSSSBSSSBBBSBBBSBSSSBSSBBBSSSBBSSBBSSBBBSSSSBBBBSBSBPPP
PPPBBBSSSBBBBBSSSSBSBBBBSSBSBBKBBSMSSSSSSSMSBBBSBBBSSBBBBBBBBBBSSSSSSSSSBSSSSBBBBSSBBBSSSSSSSSSSSPPP
PPPBBBBBSSSBSSSSBSSSSSBSSBBBBBBBBSMSSSSSSSMSBBBBBBSSBBBBBBBBBBBBBSBBSSSBBBSSBBBBBBSSBSSSSSSSSBSBSPPP
PPPBBBBBBSSSSSBBBBSBSSSSBBBBBBBBBSMSSSSSSSMSBBBBBSSBBBBBBBBBBBBBBBBBBBBBBBBBBBBBBBBSSSSSSSBBBBBBBPPP
PPPBBBBBBBBSBBBBBBBBBBSBBBBBBBBBBSMSSSSSSSMSBBBBBSSBBBBBBBBBBBBBBBBBBBBBBBBBBBBBBBBBSBSSSSBBBBBBBPPP
PPPBBBBBBBBBBBBBBBBBBBBBBBBBBBBBBSMMMMMMMMMSBBBBBBSSBBBBBBBBBBBBBBBBBBBBBBBBBBBBBBBBBSSBSSBBBBBBBPPP
PPPBBBBBBBBBBBBBBBBBBBBBBBBBBBBBBSSSSSSSSSSSBBBBBSSBBBBBBBBBBBBBBBBBBBBBBBBBBBBBBBBBSSBSSBBBBBBBBPPP
PPPBBBBBBBBBBBBBBBBKBBBBBBBBBBBBBBBSSBBBBBBBBBBBBBSSBBBBBBBBBBBBBBBBBBBBBBBBBBBBBBBSSBSSBBBBBBBBBPPP
PPPBBBBBBBBBBBBBBBBBBBBBBBBBBBAAAAAASSAABBBBBBBBBBBSSBBBBBBBBBBBBBBBBBBBBBBBBBBBBBSSBBBSSBBBBBBBBPPP
PPPPPPPPPPPPPPPPPPPPPPPPPPPPPPPPPPPPPPPPPPPPPPPPPPPPPPPPPPPPPPPPPPPPPPPPPPPPPPPPPPPPPPPPPPPPPPPPPPPP
PPPPPPPPPPPPPPPPPPPPPPPPPPPPPPPPPPPPPPPPPPPPPPPPPPPPPPPPPPPPPPPPPPPPPPPPPPPPPPPPPPPPPPPPPPPPPPPPPPPP
PPPPPPPPPPPPPPPPPPPPPPPPPPPPPPPPPPPPPPPPPPPPPPPPPPPPPPPPPPPPPPPPPPPPPPPPPPPPPPPPPPPPPPPPPPPPPPPPPPPP
